................................
................................
###..........######..........###
................................
................................
.....######..........######.....
................................
................................
################################