................................
...............C................
###..........######..........###
................................
................................
.....######..........######.....
................................
................C...............
################################